//MAP CONVERTED BY dmm2tgm.py THIS HEADER COMMENT PREVENTS RECONVERSION, DO NOT REMOVE
"a" = (
/turf/open/floor/rogue/dirt{
	color = "585F96"
	},
/area/rogue/under/underdark/dungeon)
"Q" = (
/turf/closed/mineral/random/rogue/underdark,
/area/rogue/under/underdark/dungeon)

(1,1,1) = {"
Q
Q
Q
Q
Q
a
a
a
a
a
a
a
a
a
Q
Q
Q
Q
Q
Q
"}
(2,1,1) = {"
Q
Q
a
a
a
a
a
a
a
a
a
a
a
a
a
a
a
Q
Q
Q
"}
(3,1,1) = {"
Q
a
a
a
a
a
a
a
a
a
a
a
a
a
a
a
a
a
a
Q
"}
(4,1,1) = {"
a
a
a
a
a
a
a
a
a
a
a
a
a
a
a
a
a
a
a
Q
"}
(5,1,1) = {"
a
a
a
a
a
a
a
a
a
a
a
a
a
a
a
a
a
a
a
a
"}
(6,1,1) = {"
a
a
a
a
a
a
a
a
a
a
a
a
a
a
a
a
a
a
a
a
"}
(7,1,1) = {"
a
a
a
a
a
a
a
a
a
a
a
a
a
a
a
a
a
a
a
a
"}
(8,1,1) = {"
Q
a
a
a
a
a
a
a
a
a
a
a
a
a
a
a
a
a
a
Q
"}
(9,1,1) = {"
Q
Q
Q
a
a
a
a
a
a
a
a
a
a
a
a
a
a
a
Q
Q
"}
(10,1,1) = {"
Q
Q
Q
Q
Q
Q
a
a
a
a
a
a
a
a
a
Q
Q
Q
Q
Q
"}
