//MAP CONVERTED BY dmm2tgm.py THIS HEADER COMMENT PREVENTS RECONVERSION, DO NOT REMOVE
"a" = (
/turf/closed/mineral/random/rogue/underdark,
/area/rogue/under/underdark/dungeon)
"b" = (
/mob/living/carbon/human/species/elf/dark/npc/basic,
/turf/open/floor/rogue/dirt{
	color = "585F96"
	},
/area/rogue/under/underdark/dungeon)
"H" = (
/obj/structure/chair/stool/rogue,
/turf/open/floor/rogue/dirt{
	color = "585F96"
	},
/area/rogue/under/underdark/dungeon)
"J" = (
/obj/machinery/light/rogue/campfire/densefire,
/turf/open/floor/rogue/dirt{
	color = "585F96"
	},
/area/rogue/under/underdark/dungeon)
"K" = (
/obj/structure/closet/dirthole/closed,
/obj/effect/spawner/lootdrop/roguetown/dungeon/tools,
/obj/effect/spawner/lootdrop/roguetown/dungeon/tools,
/turf/open/floor/rogue/dirt{
	color = "585F96"
	},
/area/rogue/under/underdark/dungeon)
"X" = (
/turf/open/floor/rogue/dirt{
	color = "585F96"
	},
/area/rogue/under/underdark/dungeon)

(1,1,1) = {"
a
a
X
X
X
X
X
a
a
a
"}
(2,1,1) = {"
a
K
X
X
X
X
X
X
a
a
"}
(3,1,1) = {"
a
X
X
X
X
X
X
X
X
a
"}
(4,1,1) = {"
X
X
X
X
H
X
b
X
X
X
"}
(5,1,1) = {"
X
X
X
X
X
J
X
X
X
X
"}
(6,1,1) = {"
X
X
X
X
X
X
X
X
X
X
"}
(7,1,1) = {"
a
X
X
b
X
H
X
X
X
X
"}
(8,1,1) = {"
a
X
X
X
X
X
X
X
X
a
"}
(9,1,1) = {"
a
X
X
X
X
X
X
K
a
a
"}
(10,1,1) = {"
a
a
X
X
X
X
a
a
a
a
"}
