//MAP CONVERTED BY dmm2tgm.py THIS HEADER COMMENT PREVENTS RECONVERSION, DO NOT REMOVE
"a" = (
/turf/open/floor/rogue/dirt{
	color = "585F96"
	},
/area/rogue/under/underdark/dungeon)
"k" = (
/obj/structure/closet/crate/chest/lootbox,
/turf/open/floor/rogue/dirt{
	color = "585F96"
	},
/area/rogue/under/underdark/dungeon)
"A" = (
/turf/closed/mineral/random/rogue/underdark,
/area/rogue/under/underdark/dungeon)
"H" = (
/obj/structure/chair/stool/rogue,
/turf/open/floor/rogue/dirt{
	color = "585F96"
	},
/area/rogue/under/underdark/dungeon)
"L" = (
/obj/machinery/light/rogue/campfire/densefire,
/turf/open/floor/rogue/dirt{
	color = "585F96"
	},
/area/rogue/under/underdark/dungeon)
"Z" = (
/mob/living/simple_animal/hostile/retaliate/rogue/minotaur/axe,
/turf/open/floor/rogue/dirt{
	color = "585F96"
	},
/area/rogue/under/underdark/dungeon)

(1,1,1) = {"
A
A
a
a
a
a
a
A
A
A
"}
(2,1,1) = {"
A
a
a
a
a
a
a
a
A
A
"}
(3,1,1) = {"
A
a
a
a
a
a
a
a
a
A
"}
(4,1,1) = {"
a
a
a
a
a
a
a
a
a
a
"}
(5,1,1) = {"
a
a
a
a
a
L
a
a
a
a
"}
(6,1,1) = {"
a
a
a
H
Z
a
a
a
a
a
"}
(7,1,1) = {"
A
a
a
a
a
a
k
a
a
a
"}
(8,1,1) = {"
A
a
a
a
a
a
a
a
a
A
"}
(9,1,1) = {"
A
a
a
a
a
a
a
a
A
A
"}
(10,1,1) = {"
A
A
a
a
a
a
A
A
A
A
"}
