//MAP CONVERTED BY dmm2tgm.py THIS HEADER COMMENT PREVENTS RECONVERSION, DO NOT REMOVE
"a" = (
/obj/effect/wisp{
	color = "yellow";
	desc = "Will-o'-wisps... malicious little creatures that try to lure people into traps or their doom";
	name = "Will-o'-wisp"
	},
/turf/open/floor/rogue/grass/green,
/area/rogue/under/underdark/dungeon)
"b" = (
/obj/structure/flora/roguegrass,
/obj/structure/flora/roguegrass/herb/random,
/turf/open/floor/rogue/grass/green,
/area/rogue/under/underdark/dungeon)
"c" = (
/obj/structure/flora/roguetree/normal,
/turf/open/floor/rogue/grass/green,
/area/rogue/under/underdark/dungeon)
"e" = (
/obj/item/natural/stone{
	pixel_x = -16;
	pixel_y = 16
	},
/turf/open/water/cleanshallow,
/area/rogue/under/underdark/dungeon)
"f" = (
/obj/effect/wisp{
	color = "yellow";
	desc = "Will-o'-wisps... malicious little creatures that try to lure people into traps or their doom";
	name = "Will-o'-wisp"
	},
/obj/structure/flora/roguegrass/bush/wall/tall,
/turf/open/floor/rogue/grass/green,
/area/rogue/under/underdark/dungeon)
"i" = (
/obj/item/natural/stone{
	pixel_x = 16;
	pixel_y = -16
	},
/obj/effect/wisp{
	color = "yellow";
	desc = "Will-o'-wisps... malicious little creatures that try to lure people into traps or their doom";
	name = "Will-o'-wisp"
	},
/turf/open/water/cleanshallow,
/area/rogue/under/underdark/dungeon)
"j" = (
/obj/structure/flora/roguegrass/swampweed,
/turf/open/floor/rogue/grass/green,
/area/rogue/under/underdark/dungeon)
"k" = (
/obj/structure/flora/roguetree/normal,
/obj/structure/flora/roguegrass,
/turf/open/floor/rogue/grass/green,
/area/rogue/under/underdark/dungeon)
"l" = (
/obj/structure/flora/roguegrass/maneater/real,
/obj/structure/flora/ausbushes/lavendergrass,
/obj/structure/flora/roguegrass,
/turf/open/floor/rogue/grass/green,
/area/rogue/under/underdark/dungeon)
"p" = (
/obj/structure/flora/roguegrass/thorn_bush,
/turf/open/floor/rogue/grass/green,
/area/rogue/under/underdark/dungeon)
"q" = (
/obj/effect/wisp{
	color = "yellow";
	desc = "Will-o'-wisps... malicious little creatures that try to lure people into traps or their doom";
	name = "Will-o'-wisp"
	},
/obj/structure/flora/roguegrass,
/turf/open/floor/rogue/grass/green,
/area/rogue/under/underdark/dungeon)
"s" = (
/obj/item/natural/stone,
/obj/structure/flora/roguegrass/herb/random,
/turf/open/floor/rogue/grass/green,
/area/rogue/under/underdark/dungeon)
"t" = (
/obj/structure/flora/roguegrass,
/obj/structure/flora/roguegrass,
/obj/structure/flora/roguegrass/herb/random,
/turf/open/floor/rogue/grass/green,
/area/rogue/under/underdark/dungeon)
"u" = (
/obj/item/natural/stone{
	pixel_x = 16;
	pixel_y = 16
	},
/obj/structure/flora/roguegrass/water/reeds,
/turf/open/water/cleanshallow,
/area/rogue/under/underdark/dungeon)
"v" = (
/obj/structure/flora/ausbushes/ppflowers,
/obj/structure/flora/roguegrass,
/obj/structure/flora/roguegrass,
/turf/open/floor/rogue/grass/green,
/area/rogue/under/underdark/dungeon)
"x" = (
/obj/effect/wisp{
	color = "yellow";
	desc = "Will-o'-wisps... malicious little creatures that try to lure people into traps or their doom";
	name = "Will-o'-wisp"
	},
/turf/open/water/cleanshallow,
/area/rogue/under/underdark/dungeon)
"y" = (
/turf/open/floor/rogue/grass/green,
/area/rogue/under/underdark/dungeon)
"z" = (
/obj/structure/flora/roguegrass,
/turf/open/floor/rogue/grass/green,
/area/rogue/under/underdark/dungeon)
"A" = (
/obj/effect/wisp{
	color = "yellow";
	desc = "Will-o'-wisps... malicious little creatures that try to lure people into traps or their doom";
	name = "Will-o'-wisp"
	},
/obj/structure/flora/roguegrass/herb/random,
/turf/open/floor/rogue/grass/green,
/area/rogue/under/underdark/dungeon)
"B" = (
/obj/structure/flora/roguegrass,
/obj/structure/flora/roguegrass,
/obj/structure/flora/roguegrass,
/turf/open/floor/rogue/grass/green,
/area/rogue/under/underdark/dungeon)
"E" = (
/obj/structure/flora/ausbushes/lavendergrass,
/turf/open/floor/rogue/grass/green,
/area/rogue/under/underdark/dungeon)
"F" = (
/obj/structure/flora/roguegrass/bush/wall/tall,
/turf/open/floor/rogue/grass/green,
/area/rogue/under/underdark/dungeon)
"H" = (
/turf/open/floor/rogue/dirt{
	color = "585F96"
	},
/area/rogue/under/underdark/dungeon)
"J" = (
/turf/closed/mineral/random/rogue/underdark,
/area/rogue/under/underdark/dungeon)
"K" = (
/obj/structure/flora/ausbushes/ppflowers,
/obj/effect/wisp{
	color = "yellow";
	desc = "Will-o'-wisps... malicious little creatures that try to lure people into traps or their doom";
	name = "Will-o'-wisp"
	},
/obj/structure/flora/roguegrass,
/turf/open/floor/rogue/grass/green,
/area/rogue/under/underdark/dungeon)
"L" = (
/obj/item/natural/stone,
/turf/open/floor/rogue/grass/green,
/area/rogue/under/underdark/dungeon)
"M" = (
/obj/structure/flora/roguegrass/maneater/real,
/obj/structure/flora/ausbushes/lavendergrass,
/turf/open/floor/rogue/grass/green,
/area/rogue/under/underdark/dungeon)
"N" = (
/obj/structure/flora/roguegrass,
/obj/structure/flora/roguegrass/bush,
/turf/open/floor/rogue/grass/green,
/area/rogue/under/underdark/dungeon)
"O" = (
/obj/structure/flora/roguegrass/maneater/real,
/turf/open/floor/rogue/grass/green,
/area/rogue/under/underdark/dungeon)
"P" = (
/obj/structure/flora/roguegrass/herb/random,
/turf/open/floor/rogue/grass/green,
/area/rogue/under/underdark/dungeon)
"R" = (
/obj/structure/flora/ausbushes/ppflowers,
/turf/open/floor/rogue/grass/green,
/area/rogue/under/underdark/dungeon)
"S" = (
/obj/structure/flora/roguegrass/bush,
/turf/open/floor/rogue/grass/green,
/area/rogue/under/underdark/dungeon)
"T" = (
/obj/structure/flora/junglebush,
/turf/open/floor/rogue/grass/green,
/area/rogue/under/underdark/dungeon)
"U" = (
/obj/structure/flora/roguegrass,
/obj/structure/flora/roguegrass,
/turf/open/floor/rogue/grass/green,
/area/rogue/under/underdark/dungeon)
"V" = (
/obj/item/clothing/head/peaceflower{
	pixel_y = 5
	},
/obj/structure/flora/ausbushes/lavendergrass,
/obj/structure/flora/ausbushes/ppflowers,
/obj/effect/spawner/lootdrop/roguetown/dungeon/spells,
/turf/open/floor/rogue/grass/green,
/area/rogue/under/underdark/dungeon)
"W" = (
/obj/item/natural/stone{
	pixel_x = -16;
	pixel_y = -16
	},
/obj/structure/flora/roguegrass/water/reeds,
/obj/effect/wisp{
	color = "yellow";
	desc = "Will-o'-wisps... malicious little creatures that try to lure people into traps or their doom";
	name = "Will-o'-wisp"
	},
/turf/open/water/cleanshallow,
/area/rogue/under/underdark/dungeon)
"Y" = (
/turf/open/water/cleanshallow,
/area/rogue/under/underdark/dungeon)
"Z" = (
/obj/structure/flora/junglebush,
/obj/structure/flora/roguegrass,
/turf/open/floor/rogue/grass/green,
/area/rogue/under/underdark/dungeon)

(1,1,1) = {"
J
J
J
J
J
H
H
y
y
y
y
H
H
H
J
J
J
J
J
J
"}
(2,1,1) = {"
J
J
H
H
H
H
P
p
y
P
F
P
y
H
H
H
H
J
J
J
"}
(3,1,1) = {"
J
H
H
H
A
y
E
y
k
U
l
y
R
a
y
H
H
H
H
J
"}
(4,1,1) = {"
H
H
M
y
T
R
z
z
q
s
z
Z
b
M
c
F
y
H
H
J
"}
(5,1,1) = {"
H
y
y
c
y
N
M
P
e
Y
W
P
z
z
y
y
y
c
H
H
"}
(6,1,1) = {"
H
y
y
a
l
P
B
L
x
V
Y
L
j
S
K
y
O
y
H
H
"}
(7,1,1) = {"
H
H
P
M
b
z
v
j
u
Y
i
P
T
z
y
y
y
y
H
H
"}
(8,1,1) = {"
J
H
H
H
p
P
f
Z
P
L
c
M
F
y
p
y
H
H
H
J
"}
(9,1,1) = {"
J
J
J
H
H
H
y
t
N
z
z
z
P
H
H
H
H
H
J
J
"}
(10,1,1) = {"
J
J
J
J
J
J
H
y
y
R
y
H
H
H
H
J
J
J
J
J
"}
