//MAP CONVERTED BY dmm2tgm.py THIS HEADER COMMENT PREVENTS RECONVERSION, DO NOT REMOVE
"a" = (
/obj/structure/spider/stickyweb,
/turf/open/floor/rogue/dirt{
	color = "585F96"
	},
/area/rogue/under/underdark/dungeon)
"k" = (
/obj/structure/spider/stickyweb,
/mob/living/simple_animal/hostile/retaliate/rogue/spider/mutated,
/turf/open/floor/rogue/dirt{
	color = "585F96"
	},
/area/rogue/under/underdark/dungeon)
"t" = (
/obj/effect/decal/remains/human,
/obj/item/clothing/head/roguetown/helmet,
/obj/item/clothing/suit/roguetown/armor/chainmail,
/obj/item/clothing/under/roguetown/chainlegs,
/obj/item/clothing/gloves/roguetown/chain,
/obj/item/clothing/neck/roguetown/gorget/steel,
/obj/item/clothing/wrists/roguetown/bracers,
/obj/structure/spider/stickyweb,
/obj/structure/closet/dirthole/closed,
/turf/open/floor/rogue/dirt{
	color = "585F96"
	},
/area/rogue/under/underdark/dungeon)
"x" = (
/mob/living/simple_animal/hostile/retaliate/rogue/spider/mutated,
/turf/open/floor/rogue/dirt{
	color = "585F96"
	},
/area/rogue/under/underdark/dungeon)
"A" = (
/turf/open/floor/rogue/dirt{
	color = "585F96"
	},
/area/rogue/under/underdark/dungeon)
"X" = (
/turf/closed/mineral/random/rogue/underdark,
/area/rogue/under/underdark/dungeon)

(1,1,1) = {"
X
X
A
A
A
A
A
X
X
X
"}
(2,1,1) = {"
X
a
a
X
A
A
k
a
X
X
"}
(3,1,1) = {"
X
A
k
a
A
k
a
A
A
X
"}
(4,1,1) = {"
A
a
X
t
a
a
X
a
a
a
"}
(5,1,1) = {"
A
A
a
a
a
x
A
a
x
A
"}
(6,1,1) = {"
A
k
a
a
a
a
t
a
A
A
"}
(7,1,1) = {"
X
a
X
k
A
a
a
X
a
a
"}
(8,1,1) = {"
X
A
a
a
X
x
a
a
A
X
"}
(9,1,1) = {"
X
a
a
A
A
A
A
a
X
X
"}
(10,1,1) = {"
X
X
A
A
A
A
X
X
X
X
"}
