//MAP CONVERTED BY dmm2tgm.py THIS HEADER COMMENT PREVENTS RECONVERSION, DO NOT REMOVE
"a" = (
/turf/open/water/swamp,
/area/rogue/under/underdark/dungeon)
"g" = (
/obj/effect/wisp,
/turf/open/water/swamp,
/area/rogue/under/underdark/dungeon)
"w" = (
/turf/open/water/swamp/deep,
/area/rogue/under/underdark/dungeon)
"M" = (
/turf/closed/mineral/random/rogue/underdark,
/area/rogue/under/underdark/dungeon)
"Q" = (
/obj/effect/wisp,
/turf/open/water/swamp/deep,
/area/rogue/under/underdark/dungeon)
"R" = (
/obj/effect/decal/remains/human,
/obj/item/clothing/head/roguetown/helmet,
/obj/item/clothing/suit/roguetown/armor/chainmail,
/obj/item/clothing/under/roguetown/chainlegs,
/obj/item/clothing/gloves/roguetown/chain,
/obj/item/clothing/neck/roguetown/gorget/steel,
/obj/item/clothing/wrists/roguetown/bracers,
/obj/structure/closet/dirthole/closed,
/obj/structure/gravemarker,
/turf/open/floor/rogue/dirt,
/area/rogue/under/underdark/dungeon)

(1,1,1) = {"
M
M
a
a
a
a
a
M
M
M
"}
(2,1,1) = {"
M
a
a
w
w
w
a
a
M
M
"}
(3,1,1) = {"
M
g
w
w
w
w
Q
a
a
M
"}
(4,1,1) = {"
a
a
w
a
a
a
w
w
a
a
"}
(5,1,1) = {"
a
w
w
a
R
a
w
w
w
a
"}
(6,1,1) = {"
a
a
w
a
a
a
w
w
w
a
"}
(7,1,1) = {"
M
a
Q
w
w
w
w
w
a
a
"}
(8,1,1) = {"
M
a
w
w
w
w
w
g
a
M
"}
(9,1,1) = {"
M
a
a
w
w
a
a
a
M
M
"}
(10,1,1) = {"
M
M
a
a
a
a
M
M
M
M
"}
