//MAP CONVERTED BY dmm2tgm.py THIS HEADER COMMENT PREVENTS RECONVERSION, DO NOT REMOVE
"a" = (
/obj/structure/bed/rogue/shit,
/turf/open/floor/rogue/dirt/road,
/area/rogue/under/underdark/dungeon)
"b" = (
/obj/effect/decal/remains/human,
/obj/effect/spawner/lootdrop/roguetown/dungeon,
/turf/open/floor/rogue/dirt{
	color = "585F96"
	},
/area/rogue/under/underdark/dungeon)
"i" = (
/mob/living/carbon/human/species/skeleton/npc/ambush,
/obj/structure/closet/crate/chest/crate,
/obj/effect/spawner/lootdrop/roguetown/dungeon,
/turf/open/floor/rogue/dirt/road,
/area/rogue/under/underdark/dungeon)
"u" = (
/obj/item/restraints/legcuffs/beartrap/armed/camouflage,
/turf/open/floor/rogue/dirt{
	color = "585F96"
	},
/area/rogue/under/underdark/dungeon)
"v" = (
/obj/structure/roguetent,
/obj/item/restraints/legcuffs/beartrap/armed/camouflage,
/turf/open/floor/rogue/dirt/road,
/area/rogue/under/underdark/dungeon)
"z" = (
/turf/closed/wall/mineral/rogue/tent,
/area/rogue/under/underdark/dungeon)
"B" = (
/mob/living/carbon/human/species/skeleton/npc/ambush,
/turf/open/floor/rogue/dirt/road,
/area/rogue/under/underdark/dungeon)
"D" = (
/turf/open/floor/rogue/dirt/road,
/area/rogue/under/underdark/dungeon)
"F" = (
/mob/living/carbon/human/species/skeleton/npc/ambush,
/obj/structure/bed/rogue/shit,
/turf/open/floor/rogue/dirt/road,
/area/rogue/under/underdark/dungeon)
"S" = (
/obj/structure/closet/crate/chest/crate,
/obj/effect/spawner/lootdrop/roguetown/dungeon,
/turf/open/floor/rogue/dirt/road,
/area/rogue/under/underdark/dungeon)
"V" = (
/turf/open/floor/rogue/dirt{
	color = "585F96"
	},
/area/rogue/under/underdark/dungeon)
"W" = (
/turf/closed/mineral/random/rogue/underdark,
/area/rogue/under/underdark/dungeon)

(1,1,1) = {"
W
W
W
W
W
V
V
V
u
V
V
V
V
V
W
W
W
W
W
W
"}
(2,1,1) = {"
W
W
V
V
u
V
V
V
V
V
u
b
V
V
V
V
V
W
W
W
"}
(3,1,1) = {"
W
V
V
V
V
V
V
u
b
V
V
V
V
z
z
z
z
z
V
W
"}
(4,1,1) = {"
V
V
z
z
z
z
z
V
V
V
V
V
u
z
a
i
a
z
V
W
"}
(5,1,1) = {"
V
u
z
a
D
B
z
V
z
z
v
z
V
z
D
D
B
z
V
V
"}
(6,1,1) = {"
V
b
z
S
D
D
v
V
z
S
D
z
V
z
z
v
z
z
V
V
"}
(7,1,1) = {"
V
V
z
F
D
S
z
V
z
B
D
z
V
V
V
V
V
b
u
V
"}
(8,1,1) = {"
W
V
z
z
z
z
z
V
z
F
a
z
u
V
V
V
V
V
V
W
"}
(9,1,1) = {"
W
W
W
b
u
V
V
V
z
z
z
z
V
b
V
V
V
V
W
W
"}
(10,1,1) = {"
W
W
W
W
W
W
V
u
V
V
V
V
V
V
u
W
W
W
W
W
"}
